@  ##########################################################
      #  #  #        #                    #     #     #  #  #
####  #  #  #  #  #  ####  #######  #######  ####  ####  #  #
#  #  #     #  #  #  #        #  #  #     #  #  #     #     #
#  #  #  #  #  #  #  #  #######  #  #  ####  #  #  ####  ####
#        #  #  #  #           #  #     #        #  #     #  #
#  #######  #  ####  #  #  #  #  ####  #  #######  ####  #  #
#     #     #  #     #  #  #     #        #  #              #
####  ####  #######  ##########  #######  #  #  #############
#     #           #  #        #  #     #                    #
#  #  #  #######  #  #######  #  ####  #  ####  #  ####  #  #
#  #  #  #           #        #  #     #  #     #  #     #  #
#  #  #  #######  #  #  ##########  #######  #  #  ####  ####
#  #  #  #  #  #  #     #     #  #        #  #  #  #  #  #  #
#  #######  #  #  #  #######  #  ####  #######  ####  #  #  #
#  #     #  #  #  #        #  #           #     #  #     #  #
#  #  ####  #  ####  ####  #  #######  #######  #  #  #  #  #
#  #  #     #           #     #              #  #     #     #
####  ####  #######  #######  ####  ####  #  #  #  ##########
#                    #        #     #  #  #  #  #  #  #     #
#  ################  ##########  ####  #  #  #######  #  #  #
#     #  #              #        #     #  #  #           #  #
#######  #  #  ####  #######  ####  #############  #  ####  #
#  #        #  #     #  #              #        #  #  #     #
#  #######  #######  #  ####  ####  #  #  #######  #######  #
#  #     #  #  #           #     #  #  #                 #  #
#  #  #######  #######  #######  ####  ####  #  ####  #  ####
#        #     #  #     #  #     #  #  #     #     #  #  #  #
#  #######  #  #  ####  #  #######  #  ####  ####  #  #  #  #
#     #     #                 #                 #  #  #     #
####  #  ####  ####  #######  ####  ##########  #############
#  #  #  #  #  #     #              #        #              #
#  #  #  #  #  #  ####  ####  #  ####  #######  #  ####  #  #
#  #  #  #  #  #  #     #     #  #  #     #     #  #     #  #
#  #  ####  #  ####  #######  ####  #  ####  #  #  ####  #  #
#  #  #  #  #     #  #     #  #              #  #     #  #  #
#  #  #  #  #  ##########  #  ####  ################  #######
#              #        #        #        #        #  #     #
#  ####  #  ####  ##########  #  ####  #  #######  #  #  ####
#  #     #                 #  #     #  #        #           
##########################################################  
