   ##########################################################
         #           #  #     #        #           #        #
#######  #  #######  #  #  ##########  #######  ##########  #
#              #  #  #           #     #  #     #           #
####  #  ####  #  #######  #######  ####  ####  ####  ####  #
#     #     #  #     #           #  #        #  #  #  #     #
#######  #  ####  #  #  #  #######  ####  #  #  #  ####  #  #
#        #  #     #  #  #  #  #        #  #              #  #
####  #######  ##########  #  ####  ####  #  #  #######  ####
#        #     #        #                 #  #  #     #     #
#  ##########  #  #  #######  ####  ##########  ####  #######
#        #  #  #  #     #        #  #     #           #     #
#######  #  #  #######  ####  ##########  ####  #  ####  ####
#     #        #                       #        #  #     #  #
#  #  ####  #  #  ##########  ####  #############  #  ####  #
#  #        #     #        #  #  #           #     #        #
####  #######  #  ####  ####  #  #  #  #  ################  #
#     #  #  #  #     #  #  #  #     #  #  #     #           #
#######  #  #######  #  #  #  ##########  #  ####  #  #  #  #
#  #        #  #     #        #     #           #  #  #  #  #
#  ####  ####  #  ####  ####  ####  #######  #######  ####  #
#     #     #        #  #  #        #              #     #  #
#  ####  ##########  ####  ####  ##########  ##########  #  #
#  #     #  #  #     #  #        #  #           #     #  #  #
#  ####  #  #  #  ####  #  #######  #######  #  ####  #  ####
#                    #        #        #     #              #
#  ################  #  #######  #############  ####  #######
#              #     #     #                       #        #
#  #######  #  #  #  ####  ####  ##########  #  #######  #  #
#        #  #  #  #     #  #              #  #  #        #  
##########################################################  

