   ##########################################################
   #           #  #        #           #  #     #  #  #     #
#  #######  #  #  #  ####  #  ####  #  #  #  #  #  #  ####  #
#        #  #     #  #     #  #  #  #     #  #     #     #  #
#  #  #  ####  #  #######  #  #  #############  #  ####  #  #
#  #  #  #     #  #        #        #     #  #  #           #
#  #############  ####  #  ####  #######  #  #######  #######
#  #  #        #        #           #  #  #  #              #
#  #  ####  #######  #  #  ##########  #  #  #  ####  #  ####
#     #     #        #  #     #  #  #  #     #  #  #  #  #  #
#  ####  ####  #  ####  #######  #  #  #  #######  #  #  #  #
#              #  #           #        #  #     #     #  #  #
####  #  #######  #  #######  #######  #  ####  #  ####  #  #
#     #     #     #  #                 #           #     #  #
#  #############  #  #######  ####  ####  #######  #######  #
#              #  #     #  #     #           #              #
#  ####  #######  #######  #  #  ####  #  #  ####  #  #  ####
#  #           #  #     #  #  #  #  #  #  #     #  #  #  #  #
#######  #  #  ####  ####  ####  #  ###################  #  #
#        #  #        #        #     #  #           #  #     #
#  #######  #  #############  ####  #  #######  ####  ####  #
#  #     #  #     #  #  #  #  #        #  #     #  #     #  #
#  #  #############  #  #  #  #  #  ####  ####  #  #  #  ####
#     #                 #        #                    #  #  #
#  ##########  ####  ####  ####  #  #  ####  #  ####  ####  #
#     #        #  #  #        #  #  #     #  #  #     #     #
#  ####  #######  ##########  ####  #  #######  #######  ####
#        #     #           #  #  #  #  #     #  #           #
#  #  ####  #  #  #  #  #  #  #  ####  #  #############  ####
#  #  #     #     #  #  #        #                          
##########################################################  

