   ##########################################################
      #        #  #           #                 #     #  #  #
#  #######  ####  #  #  ####  #  ####  ####  #######  #  #  #
#     #        #  #  #     #     #  #  #           #     #  #
#  #  #  #######  ####  ####  #  #  #  #  ####  ####  ####  #
#  #  #     #     #  #  #  #  #  #  #  #  #     #        #  #				THE MAZE
####  #  ####  #  #  #  #  #  ####  #######  #  #  #  #  #  #
#  #        #  #        #  #     #     #     #     #  #  #  #				LEVEL333 
#  ####  #######  #  #  #  #  #######  #  ####  #######  #  #
#  #        #     #  #  #     #           #  #  #  #  #  #  #
#  #######  #  #  ####  ###################  #  #  #  #  #  #
#     #  #  #  #  #                       #     #  #  #     #
#  ####  #  ##########  #  #  ####  #############  #  #  ####
#        #  #     #     #  #  #  #  #     #  #     #  #     #
#  ####  #  #  #  #  ##########  #  ####  #  #  ####  #  #  #
#  #  #     #  #        #  #                       #     #  #
#  #  ##########  #  ####  #  ####  #######  ####  ##########
#              #  #  #           #     #        #     #     #
#######  #  ####  ##########  #  #######  #############  ####
#        #  #     #  #     #  #        #  #  #              #
#  #  #######  #  #  ####  ####  #  #  ####  #  ####  #  ####
#  #           #        #        #  #        #     #  #  #  #
#######  ################  #######  #######  #  #  #  ####  #
#           #     #           #        #  #     #  #        #
#  ##########  ####  #  ####  #######  #  ####  ##########  #
#  #     #     #     #  #  #  #     #  #     #        #     #
#  ####  ####  ##########  #  #  ####  #  #  ####  #  #  ####
#           #     #        #     #  #     #     #  #  #  #  #
#######  ####  #  #  ##########  #  ####  #############  #  #
#              #              #        #              #     
##########################################################  

