   ##########################################################
         #              #                       #        #  #
#  ####  #  ##########  #  ##########  #######  #######  #  #
#  #  #  #  #              #  #  #           #  #           #
#  #  ####  ##########  #  #  #  ##########  #  #  #  ####  #
#              #  #     #     #           #  #  #  #     #  #
#  #  #######  #  ##########  ####  #  #######  ####  #######
#  #     #  #     #                 #        #           #  #
##########  #######  ##########  ################  ####  #  #
#                          #  #              #        #  #  #
#  ##########  ####  #######  #######  #  ################  #
#     #  #        #  #     #     #  #  #        #     #  #  #
#######  #######  ####  ####  #  #  #  #######  #  ####  #  #
#     #     #  #     #        #     #  #        #           #
#  ####  ####  #  ##########  #######  ##########  #  ####  #
#     #                    #        #  #           #  #  #  #
#  #  #  ####  #  #######  #  #######  #  ####  ####  #  #  #
#  #     #     #  #     #        #     #     #  #     #     #
####  ################  #  #############  ####  #############
#     #  #        #     #        #           #              #
#######  #  #######  ##########  #  #  ##########  #  #######
#           #     #     #           #     #        #     #  #
#######  #  #  ####  ####  #  #######  #######  #  ####  #  #
#  #     #                 #        #     #     #  #        #
#  ####  #  #######  ####  ####  #  ####  #  ####  #  #######
#        #  #  #     #     #     #  #  #  #  #     #     #  #
#  #######  #  #  #  ####  #  ####  #  #############  ####  #
#     #  #  #     #  #  #  #     #              #  #        #
#  #  #  ####  ####  #  ####  #  #  #######  #  #  ##########
#  #        #     #  #        #  #     #     #              
##########################################################  

