   ##########################################################
   #  #           #     #                                #  #
#  #  ####  ##########  #############  ##########  ####  #  #
#     #        #     #  #                    #     #        #
####  #  ##########  #  ##########  ####  #######  #  ####  #
#  #              #  #              #     #        #     #  #
#  #############  #  #  #  #######  #######  #  #############
#     #     #  #        #  #        #     #  #  #        #  #
#  #  #  ####  ################  #######  ##########  ####  #
#  #     #     #                             #  #           #
#  #  #######  ##########  #  #  #######  ####  #  #######  #
#  #        #     #     #  #  #     #  #  #        #  #     #
##########  ####  #  ####  #  ####  #  #############  ####  #
#           #              #  #                 #     #     #
#  #######  #######  #  #######  ##########  #  ####  ####  #
#  #     #  #  #     #        #        #     #  #     #     #
#######  #  #  ##########  ####  #######  #######  #######  #
#     #              #     #        #  #     #              #
#  ####  #  ######################  #  #######  #############
#  #     #              #        #           #              #
#  #  ####  #  ##########  #######  #  #  #  #  ####  #######
#  #  #     #        #  #  #        #  #  #     #           #
#  #  #######  ####  #  #  #  ####  ##########  ##########  #
#     #           #     #     #  #  #  #     #     #  #     #
#  #  ##########  ####  #  #  #  ####  ####  #######  ####  #
#  #  #              #     #     #              #           #
######################  #  ####  #######  #######  #  #  #  #
#           #        #  #     #  #  #           #  #  #  #  #
##########  #  #  #  #  ##########  ####  #  #######  ####  #
#              #  #                    #  #           #     
##########################################################  

