   ##########################################################
      #           #        #        #     #  #              #
#  ####  #  ####  #  #  ##########  #  ####  #  #  #  ####  #
#     #  #  #        #     #     #     #        #  #  #  #  #
####  #  ####  #  ##########  #######  ####  ##########  ####
#     #  #  #  #     #  #  #  #     #           #     #     #
#  #  ####  #  #######  #  #  ####  ##########  #  #######  #
#  #     #  #           #  #  #     #     #     #  #     #  #
#  ####  #  #  ####  #  #  #  #  #######  ####  #  ####  #  #
#  #              #  #  #        #  #  #     #  #  #     #  #
#######  ####  #  #######  #######  #  #  ####  #  ####  #  #
#  #        #  #                 #     #  #        #        #
#  #  #############  ####  #  #  #  #  #  #  ##########  ####
#        #     #     #     #  #  #  #           #  #  #  #  #
#  #######  #  ####  ##########  ####  #######  #  #  #  #  #
#  #     #  #        #        #              #           #  #
#  #  #  #######  #  ####  #######  #  #  #######  ####  #  #
#     #  #  #     #        #     #  #  #  #     #     #     #
####  ####  #  #  ####  ####  ##########  #  #  ####  #  #  #
#     #  #  #  #  #        #     #           #     #  #  #  #
####  #  #  ##########  ####  #  ####  #######  #  ####  #  #
#           #  #  #  #  #     #     #  #  #     #     #  #  #
#############  #  #  #######  ####  #  #  ####  #  ####  #  #
#           #  #  #     #  #  #     #  #  #     #  #     #  #
####  #  ####  #  #  ####  #  ##########  #  ##########  #  #
#     #     #  #  #  #                 #     #  #  #     #  #
####  ####  #  #  #  #############  #######  #  #  ##########
#        #                    #     #  #                 #  #
####  ##########  #  ####  ####  #  #  #######  ####  #  #  #
#     #           #     #        #              #     #     
##########################################################  

