   ##########################################################
         #  #        #  #     #        #           #  #     #
####  ####  #  #  #  #  #  ####  #  #  #  ##########  #  #  #
#  #  #  #     #  #     #        #  #        #  #     #  #  #
#  #  #  ####  #######  #  #  #  ##########  #  #  #  ####  #
#  #     #  #     #  #     #  #     #  #     #     #     #  #
#  #  #  #  ####  #  #  #  ####  ####  #  ####  ####  ####  #
#  #  #  #  #     #  #  #     #     #  #     #     #        #
#  #  #  #  ####  #  ####  #######  #  ####  #  ##########  #
#  #  #           #           #     #  #     #  #        #  #
#  #  #  #############  #############  ####  #######  #  #  #
#     #     #  #           #  #        #     #        #     #
#  ####  #  #  #############  #######  #  #  #############  #
#  #     #           #        #           #     #  #     #  #
####  ####  #  ##########  ####  ####  #######  #  ####  #  #
#        #  #     #     #     #     #        #  #     #  #  #
#  ####  #############  ####  #  ####  #  ####  #  ####  #  #
#  #     #     #        #        #     #  #        #     #  #
####  #######  ####  #  ####  #############  #######  #  #  #
#  #                 #  #           #                 #     #
#  #  ##########  #  ####  ##########  #  #######  #######  #
#           #     #     #     #  #  #  #  #           #  #  #
####  #############  #  #######  #  #  ################  ####
#  #     #     #  #  #  #           #  #     #  #           #
#  #  #######  #  #  #  #  ####  #  #  #  ####  ####  ####  #
#     #  #     #     #  #  #     #        #           #  #  #
#  ####  ####  #  ####  #######  #######  ####  ####  #  ####
#        #           #  #     #  #        #        #        #
####  #######  ####  ####  #######  #  #  #############  ####
#     #           #           #     #  #                    
##########################################################  

