   ##########################################################
      #                       #  #     #              #     #
#  ####  #######  ####  #  ####  #  #  #  #######  ####  #  #
#        #           #  #  #  #     #        #     #  #  #  #
####  #######  #  ####  ####  #############  ####  #  ####  #
#           #  #     #  #     #     #  #        #     #     #
#  #  #######  #  ##########  #  ####  ####  ##########  ####
#  #        #  #        #  #     #        #     #  #     #  #
####  ####  #  ####  ####  #  #######  #  ####  #  #  #  #  #
#     #     #  #        #           #  #        #     #  #  #
#  ####  ####  #  #######  #######  ####  ##########  ####  #
#  #     #     #              #                 #     #  #  #
####  #  #############  #############  #  ##########  #  #  #
#  #  #           #     #        #  #  #     #     #  #     #
#  #############  ####  ####  ####  ####  #######  #  ####  #
#           #  #  #     #        #           #           #  #
#  ####  #  #  #  ##########  ##########  #######  ####  #  #
#  #     #  #  #  #     #                       #  #     #  #
##########  #  #  ####  #  #  #  #  #  #  ##########  ####  #
#     #  #        #  #     #  #  #  #  #           #        #
####  #  ####  ####  #######  ####  #############  #  ####  #
#                    #  #  #  #              #     #  #  #  #
#  #  #  ##########  #  #  ####  #  ################  #  ####
#  #  #  #        #  #           #           #        #     #
####  ####  #  #  #  #######  ####  ####  ####  #  ####  #  #
#  #  #     #  #        #     #        #        #  #  #  #  #
#  ####  ####  ####  #  ##########  #  ####  ####  #  #  ####
#     #  #        #  #     #  #     #  #     #  #        #  #
#  #############  #######  #  #  #  ####  ####  #  #  #  #  #
#                       #  #     #  #     #        #  #     
##########################################################  

