   ##########################################################
                  #     #  #  #  #     #           #  #     #
##########  #  #######  #  #  #  #  #######  #  ####  ####  #
#     #     #  #              #  #  #     #  #              #
#  ####  ###################  #  #  #  #  ####  #  ##########
#        #  #  #     #                 #        #     #  #  #
#######  #  #  ####  ####  #  #######  #  #  ####  ####  #  #
#                 #        #        #  #  #  #  #        #  #
#  ####  #  #  ####  #  ##########  ####  #  #  #  ####  #  #
#  #     #  #        #  #     #        #  #     #  #        #
#######  ################  #  #  ####  #######  #  #######  #
#  #     #     #  #     #  #  #  #     #     #  #        #  #
#  #  #######  #  ####  ####  ####  #######  #  #  ##########
#           #              #        #           #        #  #
#  ####  ################  ################  #############  #
#  #        #           #     #     #  #           #     #  #
#  #######  #  ##########  ####  ####  #  #######  #  ####  #
#     #     #     #  #           #        #  #              #
##########  #  ####  ##########  #  ####  #  #  #######  ####
#     #  #     #  #  #  #  #           #     #  #     #     #
#  #  #  ####  #  #  #  #  #  ##########  ##########  #  ####
#  #           #        #     #  #              #        #  #
#  #######  #######  #  ####  #  ################  #  #  #  #
#  #     #     #     #  #     #  #  #        #  #  #  #     #
#######  #  #######  #  ####  #  #  #  ####  #  #######  #  #
#        #  #  #  #  #     #     #  #     #  #  #        #  #
#  #######  #  #  ####  ####  #  #  ####  ####  ##########  #
#           #     #           #  #     #  #           #     #
####  #  #######  #  #  #############  #  #  #  ####  #  #  #
#     #     #        #  #                    #  #        #  
##########################################################  

