   ##########################################################
   #     #     #                       #        #           #
#  #  ####  ################  #  #  #  #  #  #############  #
#           #        #        #  #  #  #  #              #  #
#######  ####  #  ##########  ####  ####  ##########  #  #  #
#           #  #  #     #        #           #  #     #  #  #
#  ##########  #  #  ####  #  #  #############  #  #######  #
#     #        #        #  #  #  #                 #        #
####  #######  #  ##########  ####  #  #######  #  #  ####  #
#  #     #     #              #  #  #  #  #     #        #  #
#  ####  ##########  ##########  #######  #  #  #######  ####
#        #     #                 #  #     #  #        #     #
#######  ####  ##########  #######  #  ####  #  #  ##########
#  #     #  #  #           #  #  #     #  #  #  #           #
#  ####  #  #  ####  #######  #  ####  #  #  #######  #  #  #
#     #  #  #     #  #                 #        #  #  #  #  #
#  #  #  #  ####  #  #  #######  ####  #######  #  ##########
#  #     #     #  #        #        #        #        #     #
#  #  ####  ####  ##########  #######  #  #######  #######  #
#  #  #  #     #                    #  #  #        #  #  #  #
#  #  #  #  #############  #############  #######  #  #  #  #
#  #  #                    #           #        #  #  #     #
#  #######  ####  ####  #  #  ####  ####  ##########  #  ####
#  #  #     #  #  #     #        #     #  #     #        #  #
#  #  #######  #  #########################  #######  ####  #
#        #           #        #           #  #              #
#  ####  #  ####  ##########  ##########  #  #  #  #  #  #  #
#  #  #     #  #                                #  #  #  #  #
#  #  ####  #  #  #  ####  ####  ####  #  #  #############  #
#  #        #     #  #        #     #  #  #              #  
##########################################################  

