   ##########################################################
   #                       #  #        #     #              #
#  ##########  #############  #  #######  ####  #############
#  #           #           #        #        #  #     #     #
#  #######  #  #  ####  ####  #######  #  ####  #  #######  #
#  #  #     #        #  #     #  #  #  #  #                 #				THE MAZE
#  #  #  #  #######  #######  #  #  #  ####  #  #  ####  ####
#     #  #        #  #  #           #  #  #  #  #     #     #     			level2
#  #######  #######  #  #######  #  #  #  #  ####  ##########
#     #     #                    #     #  #     #        #  #
#  #  #  #  #######  #  ####  ##########  #######  #  ####  #
#  #     #  #     #  #     #  #     #     #  #     #  #  #  #
#  #############  #  #######  ####  ####  #  #  #  ####  #  #
#  #  #  #        #        #        #     #  #  #           #
#  #  #  ####  ################  #######  #  ####  ####  #  #
#        #     #           #  #     #  #           #     #  #
####  ####  ####  ##########  ####  #  #  #######  #  #######
#                          #           #     #  #  #  #     #
#  #  #  #  #######  #  #  #  #######  #  #  #  #  ####  ####
#  #  #  #  #     #  #  #  #  #           #  #        #     #
#######  ####  #  ##########  #############  #  ####  #  #  #
#  #     #  #  #  #                 #  #  #  #  #        #  #
#  ####  #  ####  #  #  #  ####  #  #  #  #  ####  #  #  #  #
#           #        #  #  #     #     #        #  #  #  #  #
####  ####  #  #  #############  ####  #######  #######  ####
#        #  #  #  #  #  #        #  #     #     #  #  #     #
#  ####  #  ####  #  #  ####  ####  ##########  #  #  ####  #
#  #     #  #  #  #     #           #        #  #           #
#  ####  ####  ####  ####  #  #  ####  #  #  ####  #######  #
#  #        #              #  #        #  #     #  #        
##########################################################  

